Utterance	Intents
that is right	l_General, q_Faq
pardon	l_General, q_Faq
be quiet	l_General, q_Faq
yes	l_General, q_Faq
perfect	l_General, q_Faq
great	l_General, q_Faq
forget about it	l_General, q_Faq
that is correct	l_General, q_Faq
right	l_General, q_Faq
stop talking	l_General, q_Faq
sorry	l_General, q_Faq
goodbye	None, q_Faq
okay	l_General, q_Faq
what is my name	l_profileskill, q_Faq
hi	None, q_Faq
ok	l_General, q_Faq
hello	None, q_Faq
go away	l_General, q_Faq
not at all	l_General, q_Faq
